* Passwords *

D - Donatello
L - Leonardo
M - Michaelangelo
R - Raphael
S - Shredder


Password  Effect
LMSSL 	Alt. costume for Donatello (press special attack on char. select screen)	
MSRLR 	Alt. Costume for Leonardo (press special attack on char. select screen)	
MMMSL 	Alt. Costume for Michaelangelo (press special attack on char. select screen)	
SMLSR 	Alt. Costume for Raphael (press special attack on char. select screen)	
SLSRS 	Alternate sound effects	
DRLDS 	Attack up for Donatello	
LMLSD 	Attack up for Leonardo	
MSRMM 	Attack up for Michelangelo	
RDSRL 	Attack up for Raphael	
LRLDD 	Defense up for Donatello	
SSRSL 	Defense up for Leonardo	
LSSDR 	Defense up for Michaelangelo	
DSRRS 	Defense up for Raphael	
SDDLS 	Double power up effects for Donatello	
LDDRS 	Double power up effects for Leonardo	
LMLMS 	Double power up effects for Michaelangelo	
DLDRS 	Double power up effects for Raphael	
LSDRM 	Toy Database	
MDMSL 	Unlimited Fire Shuriken and all food is pizza for Michaelangelo	
SRRDM 	Unlimited Shuriken for Leonardo	
LDRSM 	Unlocks Master Splinter	